NO./textures/wood.xpm
SO./textures/eagle.xpm
WE./textures/greystone.xpm
EA./textures/redbrick.xpm

F 200 200 200
C 255 100 100

		   1 1
	      10101
	     1000001
	    110000011
		 1100011
	    110000011
	    100000001
	    100000001
	    100000001
	    100000001
	    100000001
	    100000001
	    100000001
	    100000001
	    10000N001
	    100000001
	    100000001
	    100000001
	    100000001
    11111000000011111
   1100000000000000011
 1110000000000000000111
 1100000000110000000011
 1100000001  1000000011
 1100000001  1000000011
 1100000001  1000000011
  11000001    10000011
   111111      111111 
