








1111111









0000