
NO ./path_to_no_texture
SO ./path_to_so_texture
WE ./path_to_we_texture
EA ./path_to_ea_texture

NO ./textures/wood.xpm
SO ./textures/eagle.xpm
WE ./textures/greystone.xpm
EA ./textures/redbrick.xpm

F 220,          100, -1
F 255       , 150 , 0
C 225         ,30      ,            0 ,7

		1111111111111111111111111
	    1000000000110000000000001
		1011000001110000000000001
		100100000000000000000T001
111111111011000001110000000000011
100000000011000001110111111111111
11110111111111011100000010001
11110111111111011101010000001
11000000110101011100000000001
10000000000000001100000000001
100000000000000011010100E0001
110000011101010111110111100011
11110111 1110101 101111010001
11111111 1111111 111111111111
